XXXXXXXXXXXXXXXXXXXXXXXXXXXXXXXXXXXXXXXXXXXXXXXXXXXXXXXXXXXXXXXXXXXXXXXXXX
Xa1047123X51023956123051X23116103812031X1X2935721X312372XX71X65173138X151X
X12638910X89191239129021X8529b902301701273013406X5X13701XX25X75XX16XX1284X
XXXXXX274X17X5X165X16X23X165999X461X23X164X612X6X4X1X65X1264X65X61X56X165X
XeX01260731X275X62X137927X76X172X7X1273X175X12731X7X571X274X17523X7X751X2X
X1X2163X125X273X12X1752X6X46X12X526X165X1624X6X624X16X561X256X1624X1642X6X
X192163X311X402165X1627X1723X12X57X27X15616237X1X3X823X18X2381X283X183X81X
X1X2545X765X567876X4345X78981XX998765012630X606156012X3X123X71X37X17d2X71X
X211123X355X212358X453X9X1259c3X32118516812X6856647135X32335X3X332X311X12X
XXXXXXXXXXXXXXXXXXXXXXXXXXXXXXXXXXXXXXXXXXXXXXXXXXXXXXXXXXXXXXXXXXXXXXXXXX

